   @@@     @@@@@@  @@@@ @@     @@
  @@ @@   @@    @@  @@  @@@   @@@
 @@   @@  @@        @@  @@@@ @@@@
@@     @@  @@@@@@   @@  @@ @@@ @@
@@@@@@@@@       @@  @@  @@     @@
@@     @@ @@    @@  @@  @@     @@
@@     @@  @@@@@@  @@@@ @@     @@ 