   ###     ######  #### ##     ##
  ## ##   ##    ##  ##  ###   ###
 ##   ##  ##        ##  #### ####
##     ##  ######   ##  ## ### ##
#########       ##  ##  ##     ##
##     ## ##    ##  ##  ##     ##
##     ##  ######  #### ##     ## 